position = position(initial) + velocity(initial)*time + (1/2)(acceleration)(time^2)
velocity(final) = velocity(initial) + acceleration*time
friction(max) = mu*force(normal) 
force(centrpedal) = mass*acceleration(cetripedal)
acceleration(centripedal) = (velocity^2)/radius
impulse = force*(delta)time
(delta)momentum = force*(delta)time
momentum = mass*velocity
work = force*displacement*cos(theta)
power = (delta)work/(delta)time
effeciency(T) = efficiency(k) + efficiency(p)
energy = mass*speed_of_light^2
force(spring) = -spring_stiffness_constant*position
work = (spring_stiffness_constant*position^2)/2
area(1)velcity(1) = area(2)velocity(2)
current = charge/time
resistance = constant_of_resistivity*length/area
resistance(equivalent) = resistance(1) + resistance(2)...
1/resistance(equivalent) = 1/resistance(1) + 1/resistance(2)
decibels = 10log(current/current(initial))
beats = (delta)frenquency
heat_transferred = mass*speed_of_light*(delta)temperature
heat_transferred = mass*latent_heat(heat)
sin(theta)(1)/sin(theta)(2) = velocity(1)/velocity(2) = index_of_refraction(2)/index_of_refraction(1) = lamda(1)/lamda(2)
index_of_refraction = speed_of_light/velocity
force(electric) = charge/electric_field
force(gravitational) = universal_gravitational_constant(mass(1)mass(2)/radius^2)
force(electrical) = coulomb_constant(charge(1)charge(2)/radius^2)
voltage = current*resistance
power = current*voltage
velocity(average) = (delta)displacement/(delta)time
acceleration(average) = (delta)velocity/(delta)time
velocity = lamda*frequency
